##########
####W   ##
#######O##
###     P#
### # #  #
###     ##
#K# # # ##
#       ##
##########
