###########
#### W ####
####XOX####
##X#X  # ##
#X XXXX  K#
# X  PXXX #
##  X  X ##
###########
