#########
##    ###
## #    #
#  ##XXX#
#  ##   #
#P ##   #
#####W  #
#########
