#########
##### P##
##     ##
##    ###
#  ######
# X  X ##
# X X  W#
#########
