##########
#P#K X####
# X X O ##
#X X XX W#
# X X XX #
## X X ###
##########
